b a a g g r g g b r 
a b g a b b g a a a 
g a b g g g g b g g 
g g g g g a g g g g 
g a g r g g a g a g 
g g g g g a g a a b 
g a g r g g a a g g 
g g g g a g a g g a 
g a a g g a g g r g 
g g g g a g g g g g 

